{
	"Part":["grass","wall","protal"],
	"Texture":{
		"grass":"../assets/map/grass.png",
		"wall":"../assets/map/wall.png",
		"protal":"../assets/map/protal.png"
	},
	"Maps":["Map1","Map2"],
	"Map1":
	{
		"TeleportPoint":{
			"x":5,
			"y":7,
			"nextMap":"Map2"
		},
		"Map":[
			[1,1,1,1,1,1,1,1,1,1,1,1,1,1,1,1],
			[1,0,0,1,0,1,0,0,0,0,1,1,0,0,1,1],
			[1,1,0,0,0,1,0,1,0,0,0,1,0,1,0,1],
			[1,0,0,0,1,0,0,0,1,1,0,0,0,0,0,1],
			[1,0,0,0,0,1,0,0,0,1,1,1,0,0,0,1],
			[1,1,0,1,0,0,0,0,0,1,1,0,0,1,1,1],
			[1,0,0,0,0,0,1,0,0,0,1,0,1,1,0,1],
			[1,3,1,0,0,0,0,1,0,1,1,0,1,0,0,1],
			[1,1,0,0,0,1,0,0,0,0,1,0,0,0,0,1],
			[1,1,1,1,1,1,1,1,1,1,1,1,1,1,1,1]
		]
	},
	"Map2":
	{
		"TeleportPoint":{
			"x":5,
			"y":3,
			"nextMap":"Map1"
		},
		"Map":[
			[1,1,1,1,1,1,1,1,1,1,1,1,1,1,1,1],
			[1,0,0,1,0,0,0,1,0,0,0,1,0,0,1,1],
			[1,0,0,0,1,1,0,1,0,1,0,0,0,0,0,1],
			[1,0,1,0,1,0,0,0,1,0,0,0,0,0,0,1],
			[1,0,1,0,0,1,0,0,0,0,1,1,0,1,0,1],
			[1,1,1,0,0,0,0,0,0,1,0,0,0,1,0,1],
			[1,0,1,0,1,0,0,1,1,1,0,0,1,1,0,1],
			[1,0,0,0,1,0,0,1,0,0,0,1,1,3,0,1],
			[1,1,0,0,0,0,0,0,1,0,0,0,0,0,1,1],
			[1,1,1,1,1,1,1,1,1,1,1,1,1,1,1,1]

		]

	}
}
